####################
#P................G#
#..................#
#..................#
#..................#
####################