############
#P....#....#
#.##..#..#.#
#.....#....#
#.####.#####
#....#....G#
#..1.......#
############