############################ 
#P..........##..........1..#
#.####.####.##.####.######.#
#.####.####.##.####.######.#
#..........................#
#.####.##.##.###.##.######.#
#.####.##.##.###.##.######.#
#....#.##....##..##..#.....#
####.#.#####.##.####.#.#####
#....#.##.....G...##.#.....#
#.####.##.###.###.##.#####.#
#.........###.###..........#
#.####.##.###.###.##.#####.#
#....#.##.........##.#.....#
####.#.##.#######.##.#.#####
#............##............#
#.####.#####.##.#####.####.#
#.####.#####.##.#####.####.#
#..........................#
#.####.#####.##.#####.####.#
#..........................#
############################