############################ 
#........................1.#
#.####.#####.##.#####.####.#
#.####.#####.##.#####.####.#
#..........................#
####.##.############.##.####
####.##.############.##.####
#....##......##......##....#
#.##.#######.##.#######.##.#
#.##.........G..........##.#
#.##.#######.##.#######.##.#
#.##.........##.........##.#
#.##.#######.##.#######.##.#
#....##......##......##....#
####.##.############.##.####
#..........................#
#.####.#####.##.#####.####.#
#.####.#####.##.#####.####.#
#............##............#
#.####.####.####.####.####.#
#P.........................#
############################