############################ 
#......................1...#
#.#####.############.#####.#
#.#####.############.#####.#
#............##............#
#.#####.##.#.##.#.##.#####.#
#.#####.##.#.##.#.##.#####.#
#.......##.#.G..#.##.......#
#.#####.##...##...##.#####.#
#.#####.####.##.####.#####.#
#............##............#
#.#####.####.##.####.#####.#
#.#####......##......#####.#
#.......####.##.####.......#
#.#####.####.##.####.#####.#
#.#####..............#####.#
#.#####.############.#####.#
#..........................#
#.#####.############.#####.#
#P.........................#
############################