############################ 
#P.........................#
#.#####.############.#####.#
#..........................#
#.##########.##.##########.#
#.##########.##.##########.#
#..........................#
############.##.############
#.............G............#
#.##########.##.##########.#
#..........................#
############.##.############
#..........................#
#.##########.##.##########.#
#.##########.##.##########.#
#..........................#
############.##.############
#..........................#
#.########################.#
#.........................1#
############################